###################
#........#........#
#.##.###.#.###.##.#
#.................#
#.##.#.#####.#.##.#
#....#...#...#....#
####.###.#.###.####
...#.#.......#.#...
####.#.##.##.#.####
.......#...#.......
####.#.#####.#.####
...#.#.......#.#...
####.###.#.###.####
#....#...#...#....#
#.##.#.#####.#.##.#
#.................#
#.##.###.#.###.##.#
#........#........#
###################