###################
#........#........#
#.##.###.#.###.##.#
#.................#
#.##.#.#####.#.##.#
#....#...#...#....#
####.###.#.###.####
---#.#.......#.#---
####.#.##.##.#.####
.......#...#.......
####.#.#####.#.####
---#.#.......#.#---
####.###.#.###.####
#....#...#...#....#
#.##.#.#####.#.##.#
#.................#
#.##.###.#.###.##.#
#........#........#
###################